X F=               X
   =                
====                
*==================#
*=*  *   * *   ***= 
 =*  *   * *     *= 
 =*   * *  *   ***=!
 =*   * *  *     *= 
 =***  *   *** ***= 
 ==================#
               =    
============== =    
             =      
     ^       =#=    
             =*=**  
     $ $     =*=@*  
==============*=====
X   #   =  K   @  T 
    =   !    M     !
W   = X =     $$    