@*#!    =
*#!    X=
#!      =
===#=====
X!      =
 !      =
!   @   =
  ^     =
     $  =
KMWT    =