=============================
=    X          *    @  K # =
=!      *  *              ##=
=               ^           =
==#=====#====================
= T F               W       =
=***                *   M   =
=!*      ^        X !       =
=============================